OOOOOOOOOOOOOOOOOOOOOOOOOOOOOOOOOO
O                  X             O
OOOOOOOOOOOOOOOOOOOOOOOOOOOOOO   O
O                                O
O             OOOOOOOOOOOOOOOOOOOO
O                                O
OOOOOOOOOOOOOOOOOOOOOOOOOOOOOOO..O
O                                O
O.OOOOOOOOOOOOOOOOOOOOOOOOOOOOOOOO
O                                U
OOOOOOOOOOOOOOOOOOOOOOOOOOOOOOOOOO
